+ ------------------------------------ +  + ------------------------------------ +
|                                      |  |                                      |
|     + ------ +     + --------- +     |  |     + --------- +     + ------ +     |
|     |        |     |           |     |  |     |           |     |        |     |
|     + ------ +     + --------- +     +  +     + --------- +     + ------ +     |
|                                                                                |
|     + ------ +     +  +     + ------------------ +     +  +     + ------ +     |
|     + ------ +     |  |     + ------ +  + ------ +     |  |     + ------ +     |
|                    |  |              |  |              |  |                    |
+ ------------ +     |  + ------ +     |  |     + ------ +  |     + ------------ +
               |     |  + ------ +     +  +     + ------ +  |     |
               |     |  |                                |  |     |
               |     |  |     + ------______------ +     |  |     |
+------------- +     +  +     |                    |     +  +     + -------------+
|                             |                    |                             |
+------------- +     +  +     |                    |     +  +     + -------------+
               |     |  |     + ------------------ +     |  |     |
               |     |  |                                |  |     |
               |     |  |     + ------------------ +     |  |     |
+ ------------ +     +  +     + ------ +  + ------ +     +  +     + ------------ +
|                                      |  |                                      |
|     + ------ +     + --------- +     |  |     + --------- +     + ------ +     |
|     + --- +  |     + --------- +     +  +     + --------- +     |  + --- +     |
|           |  |                                                  |  |           |
+ --- +     |  |     +  +     + ------------------ +     +  +     |  |     + --- +
+ --- +     +  +     |  |     + ------ +  + ------ +     |  |     +  +     + --- +
|                    |  |              |  |              |  |                    |
|     + ------------ +  + ------ +     |  |     + ------ +  + ------------ +     |
|     + ------------------------ +     +  +     + ------------------------ +     |
|                                                                                |
+ ------------------------------------------------------------------------------ +
